8 7
* * * * * * *
* O x . . x *
* x x * O x *
* . o o . . *
* . . o . . *
* . o o o . *
* . . * . . *
* * * * * * *