. . * * * . . .
. . * o * . . .
. . * . * * * *
* * * x . . . .
* o . x @ x o *
* * * * x * * *
. . . * o * . .
. . . * * * . .
