8 7
* * * * * * *
* X o . @ o *
* o o * X o *
* . x x . . *
* . . x . . *
* . x x x . *
* . . * . . *
* * * * * * *