8 8
* * * * * * * *
* . . * . . . *
* . . . . . . *
* . . * . x . *
* * . * . . . *
* X o . . * . *
* X o . x @ . *
* * * * * * * *